62
13 10
1 1 1 1 1 1 1 1 1 1 1 1 1 1 1 1 1 1 1 1 
1 2 2 2 2 1 1 1 1 1 1 1 1 1 1 1 1 1 1 1 
1 2 1 1 2 1 1 1 1 1 1 1 1 1 1 1 1 1 1 1 
1 2 1 5 3 1 1 1 1 1 1 1 1 1 1 1 1 1 1 1 
1 2 2 1 2 1 1 1 1 1 1 1 1 1 1 1 1 1 1 1 
1 2 3 6 2 1 1 2 1 2 1 4 1 1 1 1 1 1 1 1 
1 1 2 1 1 1 2 3 3 2 3 2 2 1 1 1 1 1 1 1 
1 1 2 2 2 2 2 3 3 3 1 1 1 1 1 1 1 1 1 1 
1 1 1 1 1 1 2 3 3 2 1 1 1 1 1 1 1 1 1 1 
1 1 1 1 1 1 1 1 2 1 1 1 1 1 1 1 1 1 1 1 
1 1 1 1 1 1 1 1 1 1 1 1 1 1 1 1 1 1 1 1 
1 1 1 1 1 1 1 1 1 1 1 1 1 1 1 1 1 1 1 1 
1 1 1 1 1 1 1 1 1 1 1 1 1 1 1 1 1 1 1 1 
1 1 1 1 1 1 1 1 1 1 1 1 1 1 1 1 1 1 1 1 
1 1 1 1 1 1 1 1 1 1 1 1 1 1 1 1 1 1 1 1 
1 1 1 1 1 1 1 1 1 1 1 1 1 1 1 1 1 1 1 1 
1 1 1 1 1 1 1 1 1 1 1 1 1 1 1 1 1 1 1 1 
1 1 1 1 1 1 1 1 1 1 1 1 1 1 1 1 1 1 1 1 
1 1 1 1 1 1 1 1 1 1 1 1 1 1 1 1 1 1 1 1 
1 1 1 1 1 1 1 1 1 1 1 1 1 1 1 1 1 1 1 1 
